jutro=завтра
powiedzieć=сказать
czasem=иногда
praca=работа, труд
wysoko=высоко
pa=пока
proszę=прошу, пожалуйста
dużo=много
tutaj (tu)=здесь, сюда
na dołe=внизу
więc=так что (по этому)
że=что
co=что
mieszkać=проживать
gdy=когда
kiedy=когда
ładna=красивая
piękna=прекрасная
chyba=наверное, вероятно
przekonać=убедить
spotykać=встречать
grzecznie=вежливо
sprzedać=продать
przydać się=пригодиться
odpowiadać=отвечать
człowiek=человек
wszystko=всё/все
pieniądze=деньги
złoty=злотый, золотой
zabrać=взяться
wtedy=тогда
dość=достаточно
deszcz=дождь
pada deszcz=идёт дождь
nizko=низко
rzucać=кидать
tryb=режим, порядок
szybko=быстро
wolny=медленный, свободный
okazja=возможность
kawałek=кусок
środek=середина
jeść=есть, кушать
kolacja=ужин
obiad=обед
śniadanie=завтрак
polować=охотиться
przez=через
otworzyć=открыть
zamknąć=закрыть
wciąż= всё ещё
potrafić=мочь
trafić=попасть
cześć=привет
Dzień dobry=Здравствуйте
Dobry wieczór=Добрый вечер
witam=Приветствую
na razie=до скорого
do widzenia=до свидания
do zobaczenia=до встречи
mieć na imię=меня зовут
mieć na nazwisko=моя фамилия
nazywać się=называться
być=быть
mieć=иметь
przepraszam=прошу прощения
źle=плохо, неправильно
świetnie=отлично
fatalnie=ужасно
wiele=много (только исчислимые)
bardzo=очень
wczoraj=вчера
dzisiaj (dziś)=сегодня
rano=утро
ranek=утро
który=который
do tyłu=назад
tuł=зад (задняя сторона)
do przodu=вперед
przed=перед, спереди, впереди
własność=собственность
własny=собственный
jeszcze=ещё
nagle=вдруг, внезапно
na doł=вниз
doł=низ
w górę=вверх
na górze=вверху
gdzie= где
zaraz=скоро
teraz=сейчас, теперь
akurat=точно
dokładnie=точно
oczywiście=конечно
wiedzieć=знать
patrzyć=посмотреть
oglądać=увидеть
musi=должен
zadanie=задача
przyjść=прийти
iść=идти
tutaj=здесь
o której=во сколько
książka=книга
co wieczór=каждый вечер
spotkać=встретить
przyjaciel=друг
siedzieć=сидеть
do kina=в кино
po polsku=на польском
jeżeli=если
jeśli=если
gotować=готовить
PKP=Polskie Koleje Państwowe (ЖД)
PKS=автобусная компания (автостанция)
AGD=хозтовары
pójść=пойти
tydzień=неделя
do Polski=в Польшу
pojechać=поехать
miasto=город
Kijów=Киев
stary=старый
ponad=более чем
1000 lat=1000 лет
znajduje się=он находится
jest=это
stolica=столица
kościoł=церковь, костел
zabytek, pomnik=памятник
zabytek=памятник
NAD rzeką Dniepr=НА реке Днепр
biały=белый
czarny=черный
szary=серый
zielony=зеленый
żółty=желтый
czerwony=красный
niebieski=синий/голубой
ciemnoniebieski, granatowy=темно синий
brązowy=коричневый
fioletowy=фиолетовый
różowy=розовый
pomarańczowy=оранжевый
przezroczysty=прозрачный
spoko=все ок
siema=здорова, привет (муж)
hey=эй, привет (жен)
prezent=подарок
ptasz=птенец / неоп. юнец
ptasznik=птицелов
gatunek=вид
rusałka=русалка
staw=пруд
stal=сталь
młyn=мельница
majątek=имущество / собственность
słońce=солнце
promień=луч
dłoń=ладонь
uciekać=убегать
zostać=оставаться
odrazu=немедленно
zrozumieć=понимать
rozumieć=означать
trzymać=держать
poniedziałek=понедельник
wtorek=вторник
Środa=среда
czwartek=четверг
piątek=пятница
sobota=суббота
niedziela=воскресенье
miesiąc=месяц
styczeń=январь
luty=февраль
marzec=март
kwiecień=апрель
maj=май
czerwiec=июнь
lipiec=июль
sierpień=август
wrzesień=сентябрь
październik=октябрь
listopad=ноябрь
grudzień=декабрь
wiek=век
era=эпоха
zacząć=начинать
uczyć=учить
studiować=учиться (унив)
studiować na uniwersytecie=учиться в университете
język polski=язык польский
język=язык
angielski=английский
rosyjski=русский
ukraiński=украинский
dobra=хорошо (сленг)
zeszły=прошлый (самый недавний)
miniony=минувший
przeszły=прошлое
przyszły=будущее
nastepny=следующий
kolejny=после (следующий)
kolejka=очередь
duży=большой
wielki=большой (изм)
żona=жена
kropka=точка
myślnik=дефис
kreska=тире
dwukropek=двоеточие
znak zapytania=знак вопроса
wykrzyknik=восклицательный знак
nawias=круглая скобка
nawias kwadratowy=квадратная скобка
klamra (klamerka)=фигурная скобка
matka=мать
ojciec=отец
tata=папа
rodzice=родители
brat=брат
siostra=сестра
rodzeństwo=братья и сестры
mąż=муж
małżenstwo=брак
małżonek=супруг
syn=сын
córka=дочь
dziadek=дед
babcia=бабушка
dziadkowie=дедушка и бабушка
wnuk=внук
wnuczka=внучка
krewny=родственник
wujek=дядя
ciotka=тетка
kot=кот
kotka=кошка
pies=собака
chomik=хомяк
papuga=попугай
ryba=рыба
swinka morska=морская свинка
koń=лошадь
krowa=корова
magazyn=журнал, склад
czasopismo=газета, журнал
ale=но, вот!
tylko=только
jednak=однако
póki=в то время как
dopoki=пока (в то время как)
chociaz=хотя (бы)
czy=или
czyli=то есть
natomiast=в то время как
skoro=когда
zanim=перед тем
także=также
ledwie=вряд ли
mianowicie=а именно
aczkolwiek=не смотря на (хотя)
ponieważ=потому что
poza tym=кроме этого
niż=чем
żeby=что бы
jak=как
jako=в качестве
zamiast=вместо
wieś=деревня
swiat=мир
święto=праздник
bohater=герой
dziewczyna=девушка
chłopak=мальчик (парень)
chłop=крестьянин (холоп)
zasada=правило, принцип
przeciwnie=наоборот
w przeciwieństwie=в отличие
moment=момент
inny=другой
poza=за
zastanawiać się=задумываться
myśleć=думать
skutek=эффект
na końcu=в конце
w końcu=в итоге
ciąg=последовательность
tablica=массив
lista=список
macierz=матрица
warunek=состояние
zmienna=переменная
metoda=метод
funkcja=функция
wskaźnik=указатель
odniesienie=ссылка
pętla=петля
cykl=цикл
link=ссылка
statyczna=статический
dziedziczenie=наследование
polimorfizm=полиморфизм
obiekt=объект
instancja=сущность
szablon=шаблон
algorithm=алгоритм
drzewo=дерево
poszukiwanie=поиск
środowisko=среда, обстановка
oprogramowania=ПО (софт)
programowania=программирование
narzędzie=инструмент
urządzenie=устройство, прибор
widelec=вилка
wtyczka=штепсель
łyżka=ложка
nóż=нож
sztućce=столовые приборы
patelnia=сковорода
czajnik=чайник
herbata=чай
herbatnik=чайник заварочный
ciasteczko=печенье
talerz=тарелка, пластина
kubek=чашка
filiżanka=чашка кофейная
naczynia=посуда
lodówka=холодильник
mikrofalówka=микроволновка
fala=волна
pralka=стиральная машина
zmywarka=посудомоечная машина
kuchenka=плита
garnek=горшок, кастрюля
kurz=пыль
odkurzacz=пылесос
komputer=компьютер
laptop=ноутбук
sofa=диван
fotel=стул, кресло
krzeslo=стул
szafa=шкаф
łóżko=кровать
stół=стол
przedpokój=прихожая
pokój=комната
kuchnia=кухня
łazienka=ванная
toaleta=туалет
balkon=балкон
parking=парковка
anielski=ангельский
bezpieczny=безопасный
bielizna=белье
brak=отсутствие
but=башмак
buty=ботинки
czerpenie=жатва
cierpeliwość=терпеливость
cierpienie=страдание
cieszyć się=наслаждаться
choinka=елка
ciasno=плотно, тесно
prywatny=частный
często=часто
ciasto=тесто
czas=время
zdarzyć=случаться
być w czasie=успеть
płacić=платить
wpłacić=оплатить
konto=счет
na koncie=на счету
wypłacić=выплатить
dowod=доказательство
obejrzeć=вид
własnie=собственно
całość=целостность
niektóre=некоторые
wspaniałe=отлично, великолепно
prawie=почти
więcej=больше
mniej=меньше
rzeczy=вещи
próbować=пробовать
dlaczego=почему
po co=для чего
dla tego=потому
po to=потому
wycieczka=экскурсия
rozwinięty=разработанный
melon=дыня
dynia=тыква
marchewka=морковка
ogórek=огурец
cebule=лук
ukłon=лук (оружие), кивок
rzodkiewka=редис
szczypiorek=лук зеленый
koperek=укроп
pietruszka=петрушка
masło=масло
sałata=салат (растение)
surowy=сырой
sól=соль
kasza=каша, крупа
handel=торговля
sprzedawca=продавец
kasa=касса, деньги (сленг)
z powodu=из-за
liczba=номер, количество
artykuł=статья
gwarancja=гарантия
naprawa=ремонт
pokwitowanie=квитанция
akcja=действие
promocja=акция, продвижение
przecena=уценка, скидка
detaliczny=розничный
hurtowy=оптовый
drobny=маленький, мелочь
reklamacja=жалоба
drogi=дорогой
tani=дешевый
reklamówka=листовка, пакетик
pusty=пустой
pełny=полный
hurtownia=склад
właściciel=владелец
promować=продвигать
stały klient=постоянный клиент
biegunka=понос
ból=боль
czkawka=икота
dreszcz=дрожь
gorączka=лихорадка
kac=похмелье
kaszel=кашель
katar=насморк
kichanie=чихание
krwawienie=кровотечение
krwotok=кровоизлияние
nudzić się=скучать
tęsknić=тосковать
nudnosci=тошнота
omdlenie=обморок
rana=рана
rozcieńczanie=разведение
cięcie=порез
senność=сонливость
siniak=синяк
ukąszenie=укус
wymiotowanie=рвота
wysypka=сыпь
zmęczenie=усталость
alergia=аллергия
uczulenie=аллергия (чувствит)
angina=ангина
astma=астма
bezsenność=бессонница
cukrzyca=диабет
gruźlica=туберкулез
dżuma=чума
grypa=грипп
grzybica=грибок
infekcja=инфекция
jęczmień=ячмень
kamica nerkowa=камни в почках
migrena=мигрень
gołąb=голубь
nadciśnienie=гипертония
niedociśnienie=гипотония
opryszczka=герпес
otyłość=ожирение
oparzenia=ожоги
przeziębienie=простуда
rak=рак
śpiączka=кома
udar mózgu=инсульт
wrzód żołądka=язва желудка
wstrząs mózgu=сотрясение мозга
zapalenie oskrzeli=бронхит
zapalenie płuc=пневмония
zapalenie spojówek=конъюнктивит
zapalenie wyrostka robaczkowego=аппендицит
zatrucie pokarmowe=пищевое отравление
zawał=инфаркт
zespół Downa=Синдром Дауна
złamanie=перелом
odra=корь
szczęście=счастье
radość=радость
czułość=нежность
łagodny=нежный
satysfakcja=удовлетворение
życzliwość=доброта
ulga=льгота, рельеф
trwoga=тревога
lęk=страх
niepewność=неопределенность
wahanie=нерешительность
wahadło=маятник
podejrzliwość=недоверие
oburzenie=возмущение
frustracja=разочарование
gniew=гнев
tęsknota=тоска
ufać=верить
ufność=доверие
zmartwienie=беспокойство
martwić się=беспокоиться
miłość=любовь
duma=гордость
być dumnym=гордиться
nienawiść=ненависть
fascynacja=очарование
przerazenie=ужас, перепуг
inspiracja=вдохновение
zdumienie=удивление
irytacja=раздражение
dzielnica=район
uczelnia=учебное заведение
sklep spożywczy=продуктовый магазин
sklep monopolowy=винный магазин
parter=цокольный этаж
poziom=уровень
piwnica=подвал
nowoczesny=современный
historyczny=исторический
zabytkowy=античный, антикварный
schody=лестница
ścieżka=дорожка
chodnik=пешеходная дорожка
trawnik=лужайка, газон
przejscie=переход
zajezdnia=депо
taksówka=такси
kąt=угол
trójkąt=треугольник
czworokąt=четырехугольник
trapez=трапеция
równoległobok=параллелограмм
równoległościan=параллелепипед
stopień=степеньб градус
stopni=степени, градусы
półnoć=север
południe=юг
wschód=восток
zachód=запад
swiętować=праздновать
obchodzić=отмечать
sylwester=канун Нового года
wigilia=канун
Boże narodzenie=рождество
zapamiętywać=запомнить
zapamiętać=запомнить
zapominać=забывать
zapomnieć=забыть
wesolo=весело
kupować=покупать
samodzielnie=самостоятельно
mierzyć=измерять
napięcie=напряжение
siła prądu=сила тока
opór=сопротивление
rodzaj=вид
jezioro=озеро
znajdować się=находиться
widok=вид
watło=слабо
lekko=слегка
zespołowe=командное
sprzątać=убирать, очищать
pływać=плавать
piłka nożna=футбол
piłka=мяч
koszykówka=баскетбол
siatkówka=волейбол
oscypek=овечий сыр
żyletka=бритва
kamizelka=жилет
ofiara=жертва
żertwa=жертва
żelazko=утюг
żałoba=траур
żal, smutek=печаль
żaba=лягушка
ropucha=жаба
znaczek=печать, марка
zły=злой
zdanie=предложение
propozycja=предложение
gmach=здание
zatrudnić=трудоустроить
utrudnić=затруднить
zalotny=игривый
zakon=порядок, орден
prawo=право, верно
ustawa=закон
zakaz=запрет
wzór=образец, пример
spojrzenie=взгляд
wygodny=удобный
korzystny=выгодный
zyskowny=рентабельный
szkodliwy=вредный
wredny=скверный, гнустный
woń=запах
zapach=запах
smród=вонь
wesele=свадьба
ważny=важный
wątroba=печень
uznać=признать
znać=знать
warzyć=варить
szanować=уважать
lekcja=урок
szkolenie=обучение
studiowanie=изучение
wykład=лекция
obcy=иностранный
uroda=красота
wrząca woda=кипящая вода
ukrop=кипяток
koper=укроп
ubrać=одеть
ubranie=одежда
sprzątanie=уборка
przybrać=приобретать, отбирать
przybranie=украшение
przybrany=усыновленный
twarz=лицо
tlen=кислород
taras=терраса
śmietanka=крем, сливки
szyna=рельс
opona=шина
sztuka=искусство
szczyt=вершина
sufit=потолок
krzesło=стул
ssak=млекопитающее
ssać=сосать
spisek=заговор
smutny=грустный
ryk=рев, реветь
rychły=быстрый
kruchy=рыхлый
rozkosz=наслаждение
przepych=роскошь
rozkaz=заказ, поручение
opowiadanie=рассказ, история
rozerwać się=веселиться
pysk=морда
puszka=банка железная
pukać=стучать
księż=священник
książę=принц
ksiezniczka=принцесса
księzyc=луна
prawdziwy=реальный
pozorny=кажущийся
sromotny, haniebny=постыдный
poziomka=земляника
postradać=потерять
zgubić=потерять
zaginąć=исчезать
ucierpieć=потерпеть
wspomnieć=упоминать
spokój=мир
pogrzeb=похороны
pojazd=трансп. средство
czołg=бак, танк
ciągnąć=тянуть
podobno=как бы, вироде бы
podobnie=аналогично
płot=забор
ramiona=плечи
pensja=зарплата
wynagrodzenie=вознаграждение
nagroda=приз, награда
umowa=соглашение
umowa zlecenia=акт выполненных работ
zlecenia=заказ
emerytura=пенсия
pach=подмышки
krocze=промежность
koleść=пацан (сленг)
pacan=дурак, идиот
owad=насекомое
ołów=свинец
cyna=олово
ogon=хвост
ogień=огонь
oddychać=дышать
odpoczywać=отдыхать
nawóz=удобрение
nagłe=внезапно
nabrać=принимать, занимать
narty=лыжи
myłny=фальшивый, ошибочный
mylić się=ошибаться
mydło=мыло
motyl=бабочка
mimo=несмотря на
obok=затем, возле, мимо
łaska=благодать
malarz=художник
malarz pokojowy=маляр
łyżwy=коньки
list=письмо
kozak=казак, сапоги
kopać=копать, пинать
konieczny=необходимый
końcowy=окончательный
kij=палка
karnet=абонемент, пропуск
kaczka=утка
izba=дом, палата
gwałt=насилие
grzywna=штраф
gnój=помет, навоз
gadać=говорить, болтать
reflektor=фара
fara=главный костел (уст.)
dziwny=странный
cudny=прекрасный
dzielny=храбрый, отважный
